11111111
10000P01
10C000C1
1000C001
100000 1
1000E001
11111111