1111111111111
10010000000C1
10000111110E0
1111111110000