1111111111111
100100C0000C1
1C00011111001
000011E000P01
1111111111111