1111111111111
100100C0E00C1
1C00011111001
1P00110E00001
1111111111111