11111111111111111111111111111
1P0000000000C0000000000000001
10111111111111111111111111011
10000000000000000000000000001
10111110111111111111111111011
100000010000C0000000000000001
10111111111111111111111111011
10000000000000000000000000001
10111110111111111111111111011
1C00000000000000000000C0000E1
10111111111111111111111111011
11111111111111111111111111111